11111111
1E011001
10011001
1P111101
10000001
100C0001
11111111