11111111
10000001
1E011001
1P011C01
10011001
10111101
11111111