11111111
1E000001
10011001
1P011C01
10011001
10111101
11111111