11111111111111111111
100000000000C0000001
10000P000C000HV000E1
100E000000000H0C0001
11111111111111111111