1111111111111111111111111111111111111111
1000000000000000000000000000000000000001
101000100000000000000000000CCCC0CCCC0001
10100010000000000000000000CCCCCCCCCCC001
10100010000000000000000000CCCCCCCCCCC001
101111100000000000000000000CCCCCPCCC0001
1000001000000110000000000000CCCCCCC00001
10000010000011110000000000000CCCCC000001
100000100001111110000000000000CCC0000001
1000000000111111110000001100000C00000001
1000000001000000001000100000100000000001
1000000001000000001000100001100000000001
1000000000000000000000100010100000000001
1000000000000000000000100100100000000001
1000000000000000000000101000100000000001
1000000000000000000000110000100000000001
1000000000000000000000100000100000000001
10000E0000000000000000000000000000000001
1000000000000000000000000000000000000001
1000000000000000000000000000000000000001
1111111111111111111111111111111111111111