11111111111111111111111111111111111111111111111111
10000000000000000000000000000000000000000000000001
10010001000000000000000000000000CCCC00CCCC00000001
1001000100000000000000000000000CCCCCCCCCCCC0000001
1001000100000000000000000000000CCCCCCCCCCCC0000001
10011111000000000000000000000000CCCCCPCCCC00000001
100000010000000011000000000000000CCCCCCCC000000001
1000000100000001111000000000000000CCCCC00000000001
10000001000000111111000000000000000CCC000000000001
100000000000011111111000000001100000C0000000000001
10000000000010000000010000010000010000000000000001
10000000000010000000010000010000110000000000000001
10000000000000000000000000010001010000000000000001
10000000000000000000000000010010010000000000000001
10000000000000000000000000010100010000000000000001
10000000000000000000000000011000010000000000000001
10000000000000000000000000010000010000000000000001
100000E0000000000000000000000000000000000000000001
10000000000000000000000000000000000000000000000001
10000000000000000000000000000000000000000000000001
11111111111111111111111111111111111111111111111111